############################################################
#                                                 #        #
#                                                 #        #
#                                                 #        #
#                                                    #######
#                                                    House #
#                                                          #
#                                                          #
#                                                          #
#                                                          #
#                                                          #
#                                                          #
#                                                          #
#                                                          #
#                                                          #
#                                                          #
#                                                          #
#                                                          #
#  SHOP                                                    #
##########                                                 #
#        #                                                 #       
#        #                                                 #
#        #                                                 #
#                                                          #
############################################################